#####################################################################
#            OOOOOOOOOOOOOOOOOOOOOOOOOOOOOOOOOOOOOOOO               #
#             OOOOOOOOOOOOOOOOOOOOOOOOOOOOOOOOOOOOOO                #
#              OOOOOOOOOOOOOOOOOOOOOOOOOOOOOOOOOOOO                 #
#                    OOOOOOOOOOOOOOOOOOOOOOO                        #
#                    OOOOOOOOOOOOOOOOOOOOOOO                        #
#                    OOOOOOOOOOOOOOOOOOOOOOO                        #
#                    OOOOOOOOOOOOOOOOOOOOOOO                        #
#                    OOOOOOOOOOOOOOOOOOOOOOO                        #
#                    OOOOOOOOOOOOOOOOOOOOOOO                        #
#                                                                   #
#                                                                   #
#                                                                   #
#                                                                   #
# KKKKKKKKKKKKKKKKKKKKKKK               KKKKKKKKKKKKKKKKKKKKKKKKKKK #
# KKKKKKKKKKKKKKKKKKKKKKK               KKKKKKKKKKKKKKKKKKKKKKKKKKK #
# KKKKKKKKKKKKKKKKKKKKKKK               KKKKKKKKKKKKKKKKKKKKKKKKKKK #
# KKKKKKKKKKKKKKKKKKKKKKK               KKKKKKKKKKKKKKKKKKKKKKKKKKK #
# KKKKKKKKKKKKKKKKKKKKKKK               KKKKKKKKKKKKKKKKKKKKKKKKKKK #
# KKKKKKKKKKKKKKKKKKKKKKK               KKKKKKKKKKKKKKKKKKKKKKKKKKK #
#                                                                   #
#####################################################################